118511111112
115111111111
111118111111
11111P81A111
118511111112
